....................
....................
...............#....
....................
....................
........#.....###...
....................
....................
####################
--------------------
--------------------
--------------------